{
    "test_room_1": [
        "WWWWWWWWWWWWWWWWWWWW",
        "WFFFFFFFFFFFFFFFFFFW",
        "WFFFFFFFFFFFFFFFFFFW",
        "WFFFFFFFFFFFFFFFFFFW",
        "WFFFFFFFFFFFFFFFFFFW",
        "WSFFFFFFFFFFFFFFFFFW",        
        "WWWWWWWWWWWWWWWWWWWW"
    ]
}