{
    "test_room_1": [
        "TTTTTTTTTTTTTTTTTTTTTTTTTTTTTT",
        "|............................|",
        "|...................%%%......|",
        "|...................%%%......|",
        "|...................~~~......|",
        "|...0..........P....~~~......|",
        "|............................|",
        "|............................|",
        "|............................|",
        "|..............S.............|",
        "|............................|",
        "|............................|",
        "|......................<.....|",
        "|............................|",
        "|......+.....-...............|",
        "|............................|",
        "|............................|",
        "|............................|",
        "TTTTTTTTTTTTTTTTTTTTTTTTTTTTTT"
    ],
    "test_room_2": [
        "TTTTTTTTTTTTTTTTTTTTTTTTTTTTTT",
        "|............................|",
        "|............................|",
        "|............................|",
        "|............................|",
        "|............................|",
        "|............................|",
        "|............................|",
        "|............................|",
        "|............................|",
        "|............................|",
        "|............................|",
        "|............................|",
        "|......................>.....|",
        "|............................|",
        "|............................|",
        "|............................|",
        "|............................|",
        "TTTTTTTTTTTTTTTTTTTTTTTTTTTTTT"
    ]
}