{
    "test_room_1": [
        "WWWWWWWWWWWWWWWWWWWWWWWWWWWWWW",
        "W>DXFFFFFFFFFFFFFF<FFFFFFFFFFW",
        "WFFFFFFFFFFFFFFFVVVFFFFFFFFFFW",
        "WFFFFFFFFFFFFFFFVVVFFFFFFFFFFW",
        "WFFFFFFFFFFFFFFFLLLFFFFFFFFFFW",
        "WSFFFHOFFFFFFFPFLLLFFFFFFFFFFW",
        "WFFFFFFFFFFFFFFFFFFFFFFFFFFFFW",
        "WFFFFFFFFFFFFFFFFFFFFFFFFFFFFW",
        "WFFFFFFFFFFFFFFFFFFFFFFFFFFFFW",
        "WFFFFFFFFFFFFFFFFFFFFFFFFFFFFW",
        "WFFFFFFFFFFFFFFFFFFFFFFFFFFFFW",
        "WFFFFFFFFFFFFFFFFFFFFFFFFFFFFW",
        "WFFFFFFFFFFFFFFFFFFFFFFFFFFFFW",
        "WFFFFFFFFFFFFFFFFFFFFFFFFFFFFW",
        "WFFFFFFFFFFFFFFFFFFFFFFFFFFFFW",
        "WFFFFFFFFFFFFFFFFFFFFFFFFFFFFW",
        "WFFFFFFFFFFFFFFFFFFFFFFFFFFFFW",
        "WFFFFFFFFFFFFFFFFFFFFFFFFFFFFW",      
        "WWWWWWWWWWWWWWWWWWWWWWWWWWWWWW"
    ]
}